#NIVEAU
#NOMBRE_MONSTRE 5
200	1136
1845	685
2394	685
2877	750
3480	750
#LIGNE 20
#COLONNE 150
6	6	6	6	6	6	6	6	6	6	6	6	6	6	6	6	6	6	6	6	6	6	6	6	6	6	6	6	6	6	6	6	6	6	6	6	6	6	6	6	6	6	6	6	6	6	6	6	6	6	6	6	6	6	6	6	6	6	6	6	6	6	6	6	6	6	6	6	6	6	6	6	6	6	6	6	6	6	6	6	6	6	6	6	6	6	6	6	6	6	6	6	6	6	6	6	6	6	6	6	6	6	6	6	6	6	6	6	6	6	6	6	6	6	6	6	6	6	6	6	6	6	6	6	6	6	6	6	6	6	6	6	6	6	6	6	6	6	6	6	6	6	6	6	6	6	6	6	6	6	
6	6	6	6	6	6	6	6	6	6	6	6	6	6	6	6	6	6	6	6	6	6	6	6	6	6	6	6	6	6	6	6	6	6	6	6	6	6	6	6	6	6	6	6	6	6	6	6	6	6	6	6	6	6	6	6	6	6	6	6	6	6	6	6	6	6	6	6	6	6	6	6	6	6	6	6	6	6	6	6	6	6	6	6	6	6	6	6	6	6	6	6	6	6	6	6	6	6	6	6	6	6	6	6	6	6	6	6	6	6	6	6	6	6	6	6	6	6	6	6	6	6	6	6	6	6	6	6	6	6	6	6	6	6	6	6	6	6	6	6	6	6	6	6	6	6	6	6	6	6	
6	6	6	6	6	6	6	6	6	6	6	6	6	6	6	6	6	6	6	6	6	6	6	6	6	6	6	6	6	6	6	6	6	6	6	6	6	6	6	6	6	6	6	6	6	6	6	6	6	6	6	6	6	6	6	6	6	6	6	6	6	6	6	6	6	6	6	6	6	6	6	6	6	6	6	6	6	6	6	6	6	6	6	6	6	6	6	6	6	6	6	6	6	6	6	6	6	6	6	6	6	6	6	6	6	6	6	6	6	6	6	6	6	6	6	6	6	6	6	6	6	6	6	6	6	6	6	6	6	6	6	6	6	6	6	6	6	6	6	6	6	6	6	6	6	6	6	6	6	6	
6	6	6	6	6	6	6	6	6	6	6	6	6	6	6	6	6	6	6	6	6	6	6	6	6	6	6	6	6	6	6	6	6	6	6	6	6	6	6	6	6	6	6	6	6	6	6	6	6	6	6	6	6	6	6	6	6	6	6	6	6	6	6	6	6	6	6	6	6	6	6	6	6	6	6	6	6	6	6	6	6	6	6	6	6	6	6	6	6	6	6	6	6	6	6	6	6	6	6	6	6	6	6	6	6	6	6	6	6	6	6	6	6	6	6	6	6	6	6	6	6	6	6	6	6	6	6	6	6	6	6	6	6	6	6	6	6	6	6	6	6	6	6	6	6	6	6	6	6	6	
6	6	6	6	6	6	6	6	6	6	6	6	6	6	6	6	6	6	6	6	6	6	6	6	6	6	6	6	6	6	6	6	6	6	6	6	6	6	6	6	6	6	6	6	6	6	6	6	6	6	6	6	6	6	6	6	6	6	6	6	6	6	6	6	6	6	6	6	6	6	6	6	6	6	6	6	6	6	6	6	6	6	6	6	6	6	6	6	6	6	6	6	6	6	6	6	6	6	6	6	6	6	6	6	6	6	6	6	6	6	6	6	6	6	6	6	6	6	6	6	6	6	6	6	6	6	6	6	6	6	6	6	6	6	6	6	6	6	6	6	6	6	6	6	6	6	6	6	6	6	
6	6	6	6	6	6	6	6	6	6	6	6	6	6	6	6	6	6	6	6	6	6	6	6	6	6	6	6	6	6	6	6	6	6	6	6	6	6	6	6	6	6	6	6	6	6	6	6	6	6	6	6	6	6	6	6	6	6	6	6	6	6	6	6	6	6	6	6	6	6	6	6	6	6	6	6	6	6	6	6	6	6	6	6	6	6	6	6	6	6	6	6	6	6	6	6	6	6	6	6	6	6	6	6	6	6	6	6	6	6	6	6	6	6	6	6	6	6	6	6	6	6	6	6	6	6	6	6	6	6	6	6	6	6	6	6	6	6	6	6	6	6	6	6	6	6	6	6	6	6	
6	6	6	6	6	6	6	6	6	6	6	6	6	6	6	6	6	6	6	6	6	6	6	6	6	6	6	6	6	6	6	6	6	6	6	6	6	6	6	6	6	6	6	6	6	6	6	6	6	6	6	6	6	6	6	6	6	6	6	6	6	6	6	6	6	6	6	6	6	6	6	6	6	6	6	6	6	6	6	6	6	6	6	6	6	6	6	6	6	6	6	6	6	6	6	6	6	6	6	6	6	6	6	6	6	6	6	6	6	6	6	6	6	6	6	6	6	6	6	6	6	6	6	6	6	6	6	6	6	6	6	6	6	6	6	6	6	6	6	6	6	6	6	6	6	6	6	6	6	6	
6	6	6	6	6	6	6	6	6	6	6	6	6	6	6	6	6	6	6	6	6	6	6	6	6	6	6	6	6	6	6	6	6	6	6	6	6	6	6	6	6	6	6	6	6	6	6	6	6	6	6	6	6	6	6	6	6	6	6	6	6	6	6	6	6	6	6	6	6	6	6	6	6	6	6	6	6	6	6	6	6	6	6	6	6	6	6	6	6	6	6	6	6	6	6	6	6	6	6	6	6	6	6	6	6	6	6	6	6	6	6	6	6	6	6	6	6	6	6	6	6	6	6	6	6	6	6	6	6	6	6	6	6	6	6	6	6	6	6	6	6	6	6	6	6	6	6	6	6	6	
6	6	6	6	6	6	6	6	6	6	6	6	6	6	6	6	6	6	6	6	6	6	6	6	6	6	6	6	6	6	6	6	6	6	6	6	6	6	6	6	6	6	6	6	6	6	6	6	6	6	6	6	6	6	6	6	6	6	6	6	6	6	6	6	6	6	6	6	6	6	6	6	6	6	6	6	6	6	6	6	6	6	6	6	6	6	6	6	6	6	6	6	6	6	6	6	6	6	6	6	6	6	6	6	6	6	6	6	6	6	6	6	6	6	6	6	6	6	6	6	6	6	6	6	6	6	6	6	6	6	6	6	6	6	6	6	6	6	6	6	6	6	6	6	6	6	6	6	6	6	
6	6	6	6	6	6	6	6	6	6	6	6	6	6	6	6	6	6	6	6	6	6	6	6	6	6	6	6	6	6	6	6	6	6	6	6	6	6	6	6	6	6	6	6	6	6	6	6	6	6	6	6	6	6	6	6	6	6	6	6	6	6	6	6	6	6	6	6	6	6	6	6	6	6	6	6	6	6	6	6	6	6	6	6	6	6	6	6	6	6	6	6	6	6	6	6	6	6	6	6	6	6	6	6	6	6	6	6	6	6	6	6	6	6	6	6	6	6	6	6	6	6	6	6	6	6	6	6	6	6	6	6	6	6	6	6	6	6	6	6	6	6	6	6	6	6	6	6	6	6	
6	6	6	6	6	6	6	6	6	13	14	6	6	6	6	13	14	6	6	13	14	6	6	6	6	6	6	6	6	6	6	6	6	6	6	13	14	6	6	6	6	13	14	6	6	6	6	6	13	14	6	6	6	6	6	6	13	14	6	13	14	6	6	6	6	6	6	13	14	6	6	6	6	6	6	6	6	6	6	6	6	13	14	6	6	6	6	6	6	13	14	6	6	6	6	6	6	6	6	6	6	6	6	6	6	6	6	6	6	6	6	13	14	6	6	6	6	6	6	13	14	6	6	6	6	6	6	6	6	6	6	6	6	6	6	6	6	6	6	6	6	13	14	6	6	6	6	6	6	19	
6	6	6	6	6	13	14	6	6	6	6	6	6	6	6	6	6	6	6	6	6	6	13	14	6	6	6	6	13	14	6	6	6	6	6	6	6	13	14	6	6	6	6	6	6	6	6	6	6	6	6	6	6	6	6	6	6	6	6	6	6	6	6	6	6	6	6	6	6	6	6	13	14	6	6	6	6	6	6	13	14	6	6	6	6	6	6	6	6	6	6	13	14	6	6	6	6	6	6	13	14	6	6	6	6	6	6	6	6	6	6	6	6	6	6	6	6	6	6	6	6	13	14	6	6	6	6	6	6	13	14	6	6	6	6	13	14	6	6	6	6	6	6	6	6	6	13	14	6	19	
6	6	13	14	6	6	6	6	6	6	6	13	14	6	6	6	6	13	14	6	6	6	6	6	6	6	6	6	6	6	6	6	13	14	6	6	6	6	6	6	6	6	6	13	14	6	6	6	6	6	6	13	14	6	6	6	6	6	6	6	6	6	13	14	13	14	6	6	6	6	6	6	6	6	6	6	6	6	6	6	6	6	6	6	13	14	6	6	6	6	6	6	6	6	6	6	6	6	6	6	6	13	14	6	6	6	6	6	6	13	14	6	6	6	13	14	6	6	6	6	6	6	6	6	6	6	6	6	6	6	6	13	14	6	6	6	6	6	6	13	14	6	6	6	13	14	6	6	6	19	
6	6	6	6	6	6	13	14	6	6	6	6	6	6	6	6	6	6	6	6	6	6	13	14	6	6	6	6	6	6	6	6	6	6	6	6	6	6	6	6	6	6	6	6	6	6	6	6	6	6	6	6	6	6	6	6	6	6	6	6	6	6	6	6	6	6	6	6	6	6	6	6	6	6	13	14	6	6	6	6	6	6	6	6	19	19	19	19	6	19	19	19	6	19	13	14	6	6	6	6	6	6	6	6	6	6	6	6	6	6	6	6	6	6	6	6	6	6	6	6	6	6	6	6	13	14	6	6	6	6	6	6	6	6	6	6	6	6	6	6	6	6	6	6	6	6	6	6	6	19	
13	14	6	6	6	6	6	6	6	6	6	6	19	3	23	14	6	6	6	6	6	6	6	6	6	6	6	6	6	6	6	6	19	19	19	19	6	6	6	6	6	6	6	6	6	6	6	6	6	6	6	6	6	6	13	14	6	6	6	6	6	6	6	6	6	6	6	13	14	6	6	6	6	6	6	6	6	6	6	6	6	6	6	6	19	6	6	6	6	19	6	6	6	19	6	6	6	6	6	6	6	6	6	6	13	14	6	6	6	6	6	6	6	6	6	6	6	6	6	6	6	6	6	12	12	12	12	6	6	6	6	6	6	6	13	14	6	6	6	6	6	6	6	6	6	6	26	27	6	19	
6	6	6	6	13	14	6	6	6	6	6	6	6	24	5	22	6	19	19	19	19	6	19	19	19	19	6	19	19	19	19	6	6	6	10	11	12	7	7	7	7	7	12	6	6	6	6	6	6	6	6	6	6	19	6	6	6	6	6	6	6	13	14	6	6	6	6	6	6	6	6	6	6	6	6	6	6	6	6	6	6	6	6	6	19	19	19	6	6	19	19	19	6	19	6	6	6	6	6	6	6	6	6	6	6	6	6	6	6	6	6	6	6	6	6	6	6	6	6	6	6	6	12	19	19	19	19	6	6	6	6	6	6	6	6	6	6	6	6	6	6	6	6	6	6	6	6	6	6	19	
6	6	6	6	6	6	6	6	6	6	19	22	24	5	5	25	6	6	6	6	6	6	6	6	6	6	6	6	6	6	6	10	24	1	1	1	25	19	19	19	19	19	23	3	6	22	23	6	6	6	6	6	19	19	19	6	6	6	6	6	6	6	6	6	6	6	19	19	19	19	6	6	6	6	6	6	6	6	6	6	6	6	6	6	19	6	6	6	6	6	6	19	6	19	6	6	6	19	19	19	19	19	6	6	6	6	6	6	12	6	6	6	6	6	6	6	6	6	6	6	6	12	6	19	19	19	19	6	6	6	6	6	6	6	6	6	6	6	6	6	6	26	27	6	12	6	12	6	6	19	
6	6	19	19	19	19	19	19	6	6	6	24	5	5	5	5	25	6	6	6	6	12	12	6	6	6	6	12	6	6	24	1	5	5	5	5	5	8	8	8	8	8	5	25	11	24	5	6	6	6	6	6	19	12	19	6	6	6	6	6	6	6	6	6	6	6	19	19	19	19	6	6	6	6	6	6	6	6	6	6	6	6	6	6	19	19	19	19	6	19	19	19	6	19	6	6	6	19	19	19	19	19	6	12	7	19	7	7	12	12	6	6	6	6	6	6	6	6	6	6	12	6	6	19	19	19	19	6	6	6	6	6	6	6	6	6	6	6	6	6	6	6	6	6	12	6	12	6	6	19	
4	2	6	3	2	4	4	3	2	2	24	5	5	5	5	5	5	12	6	6	12	12	12	11	6	12	11	12	11	24	5	5	5	5	5	5	5	9	9	9	9	9	5	5	1	5	5	4	2	15	15	15	12	12	11	2	16	6	6	3	15	4	11	16	2	6	6	4	2	6	6	2	4	4	3	2	6	2	6	6	6	6	6	2	6	3	2	4	4	3	2	4	2	6	3	6	6	22	3	2	22	4	12	12	3	19	19	19	12	12	12	2	11	3	15	15	15	16	12	6	6	6	12	22	3	2	4	3	6	6	22	2	22	3	2	4	2	6	3	12	4	6	6	6	12	11	12	6	2	20	
1	1	1	1	1	1	1	1	1	1	5	5	5	5	5	5	5	1	1	1	1	1	1	1	1	1	1	1	1	5	5	5	5	5	5	5	5	9	9	9	9	9	5	5	5	5	5	1	1	1	1	1	1	1	1	1	1	25	10	24	1	1	1	1	25	8	24	1	1	25	8	24	1	1	1	25	8	24	25	8	8	8	8	24	1	1	1	1	1	1	1	1	1	1	25	8	8	24	1	1	1	1	1	1	25	8	8	8	24	1	1	1	1	1	1	1	1	1	25	8	8	8	24	1	1	1	1	25	8	8	24	1	1	1	1	1	25	8	24	1	1	25	8	8	24	1	25	8	24	1
