#NIVEAU
#NOMBRE_MONSTRE 10
1200	1200
1491	1200
3017	1072
5187	1200
7378	1130
8176	1200
8645	1200
9128	1130
10100	1050
11500	1050
#LIGNE 25
#COLONNE 200
6	6	6	6	6	6	6	6	6	6	6	6	6	6	6	6	6	6	6	6	6	6	6	6	6	6	6	6	19	6	6	6	6	6	6	6	6	6	6	6	6	6	6	6	6	6	6	6	6	6	6	6	6	6	6	6	6	6	6	6	6	6	6	6	6	6	6	6	6	6	6	6	6	6	6	6	6	6	6	6	6	6	6	6	6	6	6	6	6	6	6	6	6	6	6	6	6	6	6	6	6	6	6	6	6	6	6	6	6	6	6	6	6	6	6	6	6	6	6	6	6	6	6	6	6	6	6	6	6	19	6	6	6	6	6	6	6	6	6	6	6	6	6	6	6	6	6	6	6	6	6	6	6	6	6	6	6	6	6	6	6	6	6	6	6	6	13	14	6	6	6	6	6	6	6	6	6	19	6	6	6	6	6	6	6	6	6	6	6	6	6	6	6	6	6	6	6	6	6	6	
6	13	14	6	6	6	6	6	6	19	6	6	6	6	6	6	6	6	6	6	6	6	6	6	6	6	6	19	19	19	6	6	6	6	6	6	6	6	6	6	13	14	6	6	6	6	6	6	19	6	6	6	6	6	6	6	6	6	6	6	6	6	6	6	6	6	13	14	6	6	6	6	6	6	6	6	6	6	6	13	14	6	6	6	6	6	6	6	6	6	6	6	13	14	6	6	6	6	6	6	6	6	6	6	6	13	14	6	6	6	6	6	6	6	6	6	6	6	13	14	6	6	6	6	6	6	6	6	19	19	19	6	6	6	6	6	6	6	6	6	6	6	6	6	13	14	6	6	6	6	6	6	6	6	6	6	6	6	6	6	6	6	6	6	6	6	6	6	6	6	6	6	6	6	6	6	19	19	19	6	6	6	6	6	6	6	6	6	6	6	6	6	13	14	6	6	6	6	6	6	
6	6	6	6	6	6	6	6	19	19	19	6	6	6	6	6	6	6	6	6	6	6	6	6	6	6	6	19	19	19	6	6	6	6	19	6	6	6	6	6	6	6	6	6	6	6	6	19	19	19	6	6	6	6	6	6	6	6	6	6	6	6	6	6	6	6	6	6	6	6	6	6	6	6	6	6	6	6	6	6	6	6	6	6	6	6	6	6	6	6	6	6	6	6	6	6	6	6	6	6	6	6	19	6	6	6	6	6	6	6	6	6	6	6	6	6	6	6	6	6	6	6	6	6	6	6	6	6	19	19	19	6	6	6	6	6	6	19	6	6	6	6	6	6	6	6	6	6	6	6	6	6	13	14	6	6	6	6	6	6	6	6	6	6	6	6	6	6	6	6	6	6	6	6	6	6	19	19	19	6	6	6	6	6	6	19	6	6	6	6	6	6	6	6	6	6	6	6	6	6	
6	6	6	6	6	6	13	14	19	19	19	6	6	6	6	6	13	14	6	6	6	6	6	6	6	6	6	6	19	6	6	6	6	19	19	19	6	6   6	6	6	6	6	6	13	14	6	19	19	19	6	6	6	6	13	14	6	6	6	6	6	6	6	6	6	6	6	6	6	6	6	6	6	19	6	6	6	6	6	6	6	6	6	6	6	6	6	6	6	6	6	6	6	6	6	6	6	6	6	6	6	19	19	19	6	6	6	6	6	6	6	6	6	6	6	6	6	6	6	6	6	6	6	6	6	6	6	6	6	19	6	6	6	6	6	6	19	19	19	6	6	6	6	6	6	6	6	6	6	6	6	6	6	6	6	6	6	6	6	6	6	6	6	6	6	6	6	6	6	6	6	6	13	14	6	6	6	19	6	6	6	6	6	6	19	19	19	6	6	6	6	6	6	6	6	6	6	6	6	6	
6	6	6	6	6	19	19	6	6	19	6	6	6	6	6	6	6	6	6	6	6	6	6	6	6	6	6	6	6	6	6	6	6	19	19	19	6	6	6	6	6	6	6	6	6	6	6	6	19	6	6	6	6	6	6	6	6	6	6	6	6	6	6	6	6	6	6	6	6	6	6	6	19	19	19	6	6	6	6	6	6	6	6	6	6	6	6	6	6	6	6	6	6	6	6	6	6	6	6	6	6	19	19	19	6	6	6	6	6	6	19	6	6	6	6	6	6	6	6	6	6	6	6	6	6	6	6	6	6	6	6	6	6	6	6	6	19	19	19	6	6	6	6	6	6	6	6	6	6	6	6	6	6	6	6	6	6	6	6	6	6	6	13	14	6	6	6	6	6	6	6	6	6	6	6	6	6	6	6	6	6	6	6	6	19	19	19	6	6	6	6	6	6	6	6	6	6	6	6	6	
6	6	6	6	6	26	27	6	6	6	13	14	6	6	6	6	6	6	6	6	6	6	6	13	14	6	6	6	6	6	6	13	14	6	19	6	6	6	6	6	6	6	6	6	6	6	6	6	6	6	6	6	6	6	6	6	6	6	6	6	6	6	13	14	6	6	6	6	19	19	6	6	19	19	19	13	14	6	6	6	6	19	6	6	6	6	6	6	13	14	6	6	6	6	6	6	6	6	6	6	6	6	19	6	6	6	6	6	6	19	19	19	6	6	13	14	6	6	6	6	6	6	6	6	6	6	6	6	6	6	6	6	6	6	6	6	6	19	6	6	13	14	6	6	6	6	6	6	6	6	6	6	6	6	6	6	13	14	6	6	6	6	6	6	6	6	6	6	6	6	6	19	19	6	6	6	6	6	6	6	6	6	6	6	6	19	6	6	13	14	6	6	6	6	6	6	6	6	6	6	
6	6	6	6	6	6	6	6	6	6	6	6	6	6	6	6	6	6	6	6	6	6	6	6	6	6	6	6	6	6	6	6	6	6	6	6	6	6	6	6	6	6	6	6	6	6	6	6	6	6	6	6	6	6	6	6	6	6	13	14	6	6	6	6	6	6	6	6	26	27	6	6	6	19	6	6	6	6	6	6	19	19	19	6	6	6	6	6	6	6	6	6	6	6	6	6	6	6	6	6	6	6	6	6	6	6	6	6	6	19	19	19	6	6	6	6	6	6	6	6	6	6	6	6	6	6	6	6	6	6	6	6	13	14	6	6	6	6	6	6	6	6	19	19	6	6	6	6	6	6	6	6	6	6	6	6	6	6	6	6	6	6	6	6	6	6	6	6	6	6	6	26  27	6	6	6	6	6	6	6	13	14	6	6	6	6	6	6	6	6	6	6	6	6	6	6	6	6	6	6	
6	6	10	6	6	6	6	6	6	6	6	6	6	6	6	6	6	6	6	6	19  19	6	6	6	13	14	6	3	6	6	6	6	6	6	6	6	6	6	6	6	6	13	14	6	6	6	6	6	6	6	6	6	6	6	6	6	6	6	6	6	6	6	6	6	6	6	6	6	6	6	6	6	6	6	6	6	6	6	6	19	19	19	6	6	6	6	6	6	6	6	6	6	6	6	6	19	19	6	6	6	6	6	6	6	6	6	6	6	6	19	6	6	6	6	6	6	6	6	6	6	6	6	6	6	6	6	6	6	6	6	6	6	6	6	6	6	6	6	6	6	6	26	27	6	6	6	6	6	6	6	6	6	6	6	6	6	6	6	6	6	6	6	6	6	6	13	14	6	6	6	6	6	6	6	6	6	6	6	6	6	6	6	6	6	6	6	6	6	6	6	6	6	6	6	6	6	6	6	6	
6	6	12	12	12	6	6	6	6	6	6	6	6	6	6	6	6	6	6	6	26	27	6	6	6	6	6	6	12	12	6	6	6	6	6	6		6	6	6	13	14	6	6	6	6	6	6	3	6	6	6	6	19	6	6	19	19	6	6	6	6	6	6	6	6	13	14	6	6	6	6	6	6	6	6	6	6	6	13	14	19	6	6	6	6	6	6	6	6	6	6	13	14	6	6	26	27	6	6	6	6	6	6	6	13	14	6	6	6	6	6	6	6	6	6	6	6	13	14	6	6	6	6	6	6	6	6	6	3	6	6	6	6	6	6	6	6	6	6	6	6	6	6	13	14	6	6	6	6	6	6	6	6	6	6	6	6	6	6	6	6	6	6	6	6	6	6	6	6	6	6	6	6	6	6	6	3	6	6	6	6	6	6	6	6	6	6	6	6	6	6	13	14	6	6	6	6	6	6	
6	6	6	6	6	6	6	6	6	3	6	6	6	6	6	19	6	6	6	6	6	6	6	6	6	6	6	6	6	6	6	6	6	6	3	6	6	6	6	6	6	6	6	6	6	6	6	24	1	1	25	6	6	19	6	6	26	27	6	6	6	6	6	6	6	6	6	6	6	6	6	6	6	6	6	6	6	6	6	6	6	6	6	6	6	6	6	6	6	6	6	6	6	6	6	6	6	6	6	6	6	6	6	6	6	6	6	6	6	6	6	6	6	6	6	6	6	6	6	6	6	6	6	6	6	6	6	6	6	12	12	6	6	6	6	6	6	3	6	6	6	6	6	6	6	6	6	6	6	6	6	6	13	14	6	6	6	6	6	6	6	6	6	6	6	6	6	6	6	6	6	6	12	6	6	6	6	12	12	6	6	6	6	6	6	3	6	6	6	6	6	6	6	6	6	6	6	6	6	6	
6	6	6	6	6	6	6	6	24	1	1	25	6	6	6	19	6	6	6	6	6	6	6	6	6	6	6	6	6	6	6	6	6	12	12	12	6	6	6	6	6	6	6	6	6	6	6	6	6	6	6	6	6	19	6	6	6	6	6	6	6	6	6	6	6	6	6	6	6	6	6	6	6	6	6	6	6	6	6	6	6	6	6	6	6	6	6	6	6	6	6	6	6	6	6	6	6	6	6	6	6	6	3	6	6	6	6	6	6	6	6	6	6	6	6	6	6	6	6	6	6	6	6	6	6	6	6	6	6	6	6	6	6	6	6	12	12	12	6	6	6	6	6	6	6	6	6	6	6	6	6	6	6	6	6	6	6	6	6	6	6	6	6	6	6	6	6	6	6	6	6	6	6	6	6	6	6	6	6	6	6	6	6	12	12	12	6	6	6	6	6	6	6	6	6	6	6	6	19	6	
6	6	6	6	6	6	6	6	6	6	6	6	6	6	6	19	6	6	6	6	6	6	6	6	6	6	6	6	6	6	6	6	6	6	6	6	6	6	6	6	6	6	6	6	6	6	6	6	6	6	6	6	6	19	6	6	6	6	6	6	6	6	6	6	6	6	6	6	6	6	6	6	6	3	6	6	6	6	6	6	6	6	6	6	6	6	6	6	6	6	6	6	6	6	6	6	6	6	6	6	6	6	12	12	6	6	6	6	6	6	3	6	6	6	6	6	6	6	6	6	6	6	6	6	6	6	6	6	6	6	6	6	6	6	6	6	6	6	6	6	6	6	6	6	6	6	6	6	6	6	6	6	6	6	6	6	6	6	6	6	6	6	13	14	6	6	6	6	6	6	6	6	6	6	6	6	6	6	6	6	6	6	6	6	6	6	6	6	6	6	6	6	6	6	6	6	6	19	19	19	
6	6	6	6	6	6	6	6	6	6	13	14	6	6	6	19	6	6	6	6	6	6	6	13	14	6	6	6	6	6	6	6	6	6	6	6	13	14	6	6	6	6	6	6	6	6	6	6	19	6	6	6	6	6	6	6	6	6	6	6	6	6	13	14	6	6	6	6	6	6	6	6	6	12	12	13	14	6	6	6	6	3	6	6	6	6	6	6	13	14	6	6	6	6	6	6	6	6	6	6	6	13	14	6	6	6	6	6	12	12	12	6	6	6	13	14	6	6	6	6	6	6	6	6	7	7	6	6	6	6	6	6	6	6	6	6	6	6	6	6	13	14	6	6	6	6	6	6	6	6	6	6	6	6	6	6	13	14	6	6	6	6	6	6	6	6	6	6	6	12	6	6	6	6	6	13	14	6	6	6	6	6	6	6	6	6	6	6	13	14	6	6	6	6	6	6	6	6	19	6	
6	6	6	6	6	6	19	6	6	6	6	6	6	6	6	6	6	6	6	6	6	6	6	6	6	6	6	6	6	6	6	6	6	6	6	6	6	6	6	6	6	6	6	6	6	6	6	19	19	19	6	6	4	3	6	15	6	6	6	6	6	6	6	6	6	6	6	6	6	6	6	6	6	6	6	6	6	6	6	12	12	12	6	6	6	6	6	6	19	6	6	6	6	6	6	6	6	7	7	6	6	6	6	6	6	6	6	6	6	6	6	6	6	6	6	6	6	6	6	19	6	6	6	6	6	6	6	6	6	4	2	6	6	6	6	6	6	6	6	6	6	6	6	6	6	6	6	6	6	6	6	6	6	6	6	6	6	6	6	6	6	6	6	6	6	6	6	6	6	6	6	6	6	6	6	6	6	6	6	6	6	6	6	6	6	6	6	6	6	6	6	6	6	6	6	6	6	6	6	6	
6	6	6	6	6	6	19	6	6	6	19	6	6	6	4	3	6	15	6	6	6	6	6	6	6	6	6	6	6	6	6	6	6	6	6	15	15	6	6	6	6	3	6	6	6	6	19	6	10	6	19	6	24	1	1	25	6	6	6	6	6	6	6	6	6	6	6	6	6	19	6	6	6	6	6	6	6	6	6	6	6	6	6	6	6	6	6	6	19	6	6	6	7	7	6	6	6	6	6	6	6	6	6	6	6	6	6	6	6	6	6	6	6	6	6	6	6	6	19	19	19	6	6	6	6	6	6	6	24	1	25	6	6	6	6	6	4	2	6	6	6	6	6	6	6	6	6	6	6	6	6	19	6	6	6	6	6	19	6	6	6	6	6	6	12	6	13	14	6	6	6	6	6	19	6	6	6	6	6	19	6	6	6	6	6	6	6	6	6	6	6	6	6	6	6	6	6	6	19	6	
6	13	14	6	6	6	19	6	6	6	19	6	6	6	24	1	1	25	6	6	6	6	6	6	6	6	6	13	14	6	6	3	6	6	24	1	25	6	6	6	24	25	10	6	6	6	6	6	12	6	6	6	6	6	6	6	6	6	6	6	6	6	6	6	6	6	13	14	6	19	6	6	6	6	6	6	6	6	6	13	14	6	6	6	6	6	6	6	19	6	6	6	13	14	6	6	6	6	6	6	6	6	4	2	6	6	6	6	6	6	6	6	6	6	6	6	6	19	19	19	19	19	6	6	6	6	6	6	6	6	6	6	6	6	6	24	1	25	6	6	6	6	6	6	13	14	6	6	6	6	19	19	19	6	6	6	6	19	6	6	6	6	6	6	6	6	6	6	6	6	6	6	19	19	19	6	6	6	6	19	6	6	6	19	6	6	6	6	6	6	6	6	13	14	6	6	6	6	19	6	
6	6	6	6	6	6	12	6	6	6	19	6	6	6	6	6	6	6	6	6	6	6	6	6	6	6	6	6	6	6	12	12	6	6	5	5	5	6	6	6	5	5	1	25	6	6	6	6	6	6	6	6	6	6	6	6	6	6	6	6	6	6	6	6	6	6	6	6	6	19	6	6	6	6	6	6	6	6	6	6	6	6	6	6	6	6	6	6	6	6	6	6	6	6	6	6	6	6	6	6	6	24	1	25	6	6	6	6	6	4	2	6	6	6	6	6	19	19	6	6	6	19	19	6	6	6	6	6	6	6	6	6	6	6	6	6	6	6	6	6	6	6	6	6	6	6	6	6	6	19	19	6	19	19	6	6	6	19	6	6	6	6	6	6	6	6	6	6	6	6	6	19	19	6	19	19	6	6	6	19	6	6	6	19	6	6	6	6	6	6	6	6	6	6	6	6	6	6	19	6	
6	6	6	6	6	6	12	7	7	7	12	6	6	6	6	6	6	6	6	6	6	6	6	6	6	6	6	6	19	6	6	6	6	6	5	5	5	6	6	6	6	5	5	5	25	10	6	6	2	15	16	2	4	6	6	6	6	6	6	6	19	6	6	6	6	6	7	7	6	19	6	7	7	6	6	6	6	6	6	6	6	6	6	6	6	6	6	6	12	6	6	6	6	6	6	6	12	12	6	6	6	6	6	6	6	6	6	6	24	1	25	6	6	6	6	6	19	6	6	6	6	6	19	6	6	6	6	6	6	6	6	6	6	6	6	6	6	6	6	6	6	6	6	6	6	6	6	6	6	6	6	10	6	6	6	6	6	12	6	6	6	19	6	6	6	6	6	6	6	6	6	6	6	10	6	6	6	6	6	12	6	6	6	19	6	6	6	6	6	6	6	6	6	6	6	6	6	6	6	6	
12	6	6	6	6	6	6	6	6	6	6	6	6	6	6	6	6	6	6	6	6	6	6	6	6	6	6	19	6	19	6	6	6	6	5	5	5	6	6	19	19	6	5	5	5	1	1	1	1	1	1	1	25	6	6	6	6	6	6	19	19	19	6	6	6	6	6	6	6	19	6	6	6	6	6	6	6	6	6	6	6	6	6	6	6	6	6	6	12	6	6	6	6	6	6	6	6	6	6	6	6	6	6	6	6	6	6	6	6	6	6	6	6	6	2	6	3	6	6	6	6	6	6	6	6	6	6	6	6	6	6	6	6	6	6	6	6	6	6	6	6	22	6	6	6	6	6	6	7	6	6	12	6	6	7	6	6	12	7	7	7	12	6	6	6	6	6	6	6	7	7	6	6	12	6	6	7	6	6	12	7	7	7	12	6	6	6	6	6	6	6	6	6	6	6	6	6	6	6	6	
1	25	6	6	6	6	6	6	6	6	6	6	6	6	6	6	6	6	6	6	6	6	6	6	16	16	6	6	6	6	6	6	6	6	5	5	5	6	6	19	19	6	6	6	5	5	19	19	19	5	5	6	6	6	6	6	6	6	19	19	6	19	19	6	6	6	6	6	6	19	6	6	6	6	6	6	6	6	6	6	2	6	3	10	10	6	11	11	12	6	6	6	6	6	10	10	10	10	10	6	6	6	6	6	6	6	6	6	6	6	6	6	6	6	24	1	1	1	1	1	1	1	25	6	6	22	6	4	4	4	6	6	6	6	6	4	4	4	6	24	1	1	1	1	25	6	6	6	6	6	6	6	6	6	6	6	6	6	6	6	6	12	6	6	6	6	6	6	6	6	6	6	6	6	6	6	6	6	6	6	6	6	6	12	6	6	6	6	6	6	6	6	6	6	6	22	6	4	3	6	
5	5	17	17	17	17	17	6	6	6	6	6	6	6	6	6	6	6	7	7	7	24	1	1	1	25	6	6	6	6	6	2	6	3	5	5	5	6	6	19	19	6	6	6	19	19	19	19	19	19	19	19	6	6	6	6	6	6	6	6	10	6	6	6	6	6	6	6	6	19	6	6	6	7	7	7	6	6	6	6	24	1	1	1	1	6	1	1	1	6	6	6	6	6	1	1	1	1	1	6	6	6	6	6	6	6	6	6	6	6	6	6	6	6	5	5	5	5	5	5	5	5	5	6	24	1	1	1	1	1	25	6	24	1	1	1	1	1	25	5	5	5	5	5	5	6	6	6	6	6	6	6	6	6	6	6	6	6	6	6	6	6	6	6	7	7	6	6	6	6	6	6	17	6	6	6	6	17	6	6	6	6	6	6	6	6	7	7	7	6	6	6	6	6	24	1	1	1	1	25	
5	5	18	18	18	18	18	17	17	17	17	6	6	6	6	6	6	6	19	19	19	5	5	5	5	5	8	8	8	8	1	1	1	1	5	5	5	6	6	19	19	6	6	19	19	19	19	19	19	19	19	19	19	6	6	6	6	7	6	6	12	6	6	7	6	6	6	6	6	6	6	6	6	6	6	6	6	6	6	6	5	5	5	19	19	19	19	5	5	6	6	3	6	6	5	5	5	5	5	8	8	8	8	8	6	6	6	6	6	6	6	6	6	6	6	6	6	19	19	5	5	5	6	6	6	5	5	19	19	6	6	6	6	5	5	19	19	6	6	19	19	19	19	6   6	6	6	6	6	6	6	6	6	6	6	6	6	6	6	6	6	6	6	6	6	6	6	6	6	6	6	17	18	6	6	6	6	18	6	6	6	6	6	6	6	6	6	6	6	6	6	6	10	6	5	5	19	19	6	6	
5	5	18	18	18	18	18	18	18	18	18	17	17	17	24	1	25	6	19	19	19	5	5	5	5	5	9	9	9	9	5	5	5	5	5	5	5	6	6	7	7	7	6	19	19	19	19	6	6	19	19	19	19	7	6	6	17	17	17	17	17	17	17	17	17	17	6	6	7	7	7	6	6	17	17	17	17	17	17	17	5	5	5	19	19	19	19	6	6	6	6	23	6	6	5	5	5	5	5	9	9	9	9	9	8	8	8	8	8	6	6	6	6	6	6	6	6	19	19	19	19	6	6	6	6	6	6	19	19	6	6	6	6	6	6	19	19	6	6	19	19	19	19	6	6	6	6	3	6	6	6	17	17	17	17	17	17	17	6	6	6	6	6	6	17	17	6	6	6	17	17	18	18	6	6	6	6	18	17	17	6	6	6	6	6	6	17	17	17	17	17	17	5	6	19	19	19	19	6	20	
5	5	18	18	18	18	18	18	18	18	18	18	18	18	5	5	5	5	19	19	19	5	5	5	5	5	9	9	9	9	5	5	5	5	5	5	5	17	17	17	17	17	17	6	6	7	6	6	6	7	6	6	6	17	17	17	18	18	18	18	18	18	18	18	18	18	17	17	17	17	17	17	17	18	18	18	18	18	18	18	5	5	5	19	19	10	19	6	6	6	10	5	8	8	5	5	5	5	5	9	9	9	9	9	9	9	9	9	9	8	8	8	8	8	5	5	5	10	19	19	19	6	6	10	6	6	6	19	19	5	5	10	6	6	6	19	10	5	5	19	19	10	19	6	6	24	1	25	17	17	17	18	18	18	18	18	18	18	17	17	17	17	17	17	18	18	17	17	17	18	18	18	18	17	17	17	17	18	18	18	17	17	17	17	17	17	18	18	18	18	18	18	5	6	19	19	19	10	5	5	
5	5	18	18	18	18	18	18	18	18	18	18	18	18	5	5	5	5	1	1	1	5	5	5	5	5	9	9	9	9	5	5	5	5	5	5	5	18	18	18	18	18	18	17	17	17	17	17	17	17	17	17	17	18	18	18	18	18	18	18	18	18	18	18	18	18	18	18	18	18	18	18	18	18	18	18	18	18	18	18	5	5	5	5	5	5	5	5	5	5	5	5	9	9	5	5	5	5	5	9	9	9	9	9	9	9	9	9	9	9	9	9	9	9	5	5	5	5	5	5	5	5	5	5	5	5	5	5	5	5	5	5	5	5	5	5	5	5	5	5	5	5	5	5	5	5	5   5	18	18	18	18	18	18	18	18	18	18	18	18	18	18	18	18	18	18	18	18	18	18	18	18	18	18	18	18	18	18	18	18	18	18	18	18	18	18	18	18	18	18	18	18	5	5	5	5	5	5	5	5
