#NIVEAU
#NOMBRE_MONSTRE 13
512	512
768	1344
2560	512
2816	1152
4928	832
6016	1344
6208	512
7040	1216
8320	1216
10112	448
13120	512
11520	1024
14464	384
#LIGNE 25
#COLONNE 250
6	6	6	6	6	6	6	6	6	6	6	6	6	6	6	6	6	6	6	6	6	6	6	6	6	6	6	6	6	6	6	6	6	6	6	6	6	6	6	6	6	6	6	6	6	6	6	6	6	6	6	6	6	6	6	6	6	6	6	6	6	6	6	6	6	6	6	6	6	6	6	6	6	6	6	6	6	6	6	6	6	6	6	6	6	6	6	6	6	6	6	6	6	6	6	6	6	6	6	6	6	6	6	6	6	6	6	6	6	6	6	6	6	6	6	6	6	6	6	6	6	6	6	6	6	6	6	6	6	6	6	6	6	6	6	6	6	6	6	6	6	6	6	6	6	6	6	6	6	6	6	6	6	6	6	6	6	6	6	6	6	6	6	6	6	6	6	6	6	6	6	6	6	6	6	6	6	6	6	6	6	6	6	6	6	6	6	6	6	6	6	6	6	6	6	6	6	6	6	6	6	6	6	6	6	6	6	6	6	6	6	6	6	6	6	6	6	6	6	6	6	6	6	6	6	6	6	6	6	6	6	6	6	6	21	21	21	21	6	21	6	21	6	6	6	21	6	6	6	6	
6	6	6	6	6	6	13	14	6	6	6	6	6	6	6	6	13	14	6	6	6	6	6	6	6	6	6	6	6	6	13	14	6	6	6	6	6	6	6	6	6	6	6	6	6	6	6	6	6	6	6	6	6	13	14	6	6	6	6	6	6	6	6	6	6	6	6	6	6	6	6	6	6	6	6	6	6	6	6	6	6	6	6	6	6	6	6	6	6	6	6	6	6	6	6	6	6	6	6	6	6	6	6	6	6	6	6	6	6	6	6	6	6	6	6	6	6	6	6	6	6	6	6	6	6	6	6	6	6	6	6	13	14	6	6	6	6	6	6	6	6	6	6	6	6	6	6	6	6	6	6	6	6	6	19	19	6	6	6	6	19	19	6	6	6	6	6	6	6	13	14	6	6	6	6	6	6	6	6	6	6	6	6	6	6	6	6	6	6	6	6	6	6	6	13	14	6	6	6	6	6	6	6	6	6	6	6	6	6	6	6	6	6	6	6	6	6	6	13	14	6	6	6	6	6	6	6	6	6	6	6	6	6	6	21	6	6	6	6	21	6	21	21	6	6	21	6	6	6	6	
6	6	6	6	6	6	6	6	6	6	6	6	6	6	6	6	6	6	6	6	6	6	6	6	6	6	6	6	6	6	6	6	6	6	6	6	6	19	19	6	6	6	6	19	19	6	6	6	6	6	6	6	6	6	6	6	6	6	6	6	6	6	13	14	6	6	6	6	6	6	6	6	13	14	6	6	6	6	6	6	6	6	6	6	6	6	6	6	6	6	6	6	6	6	19	19	6	6	6	6	19	19	6	6	6	6	6	6	6	6	13	14	6	6	6	6	6	6	6	6	6	6	6	6	6	6	6	6	6	6	6	6	6	6	6	6	6	6	6	6	13	14	6	6	6	6	6	6	6	6	6	6	6	6	19	19	6	6	6	6	19	19	6	6	6	6	6	6	6	6	6	6	6	6	6	6	6	6	13	14	6	6	6	6	6	6	6	6	6	6	6	6	6	6	6	6	6	6	6	6	6	6	19	19	6	6	6	6	19	19	6	6	6	13	14	6	6	6	6	6	6	6	6	6	13	14	6	6	6	6	6	6	6	6	21	21	6	6	6	21	6	21	6	21	6	21	6	6	6	6	
6	6	6	6	6	6	6	6	6	6	6	6	6	6	6	6	6	6	6	6	6	6	6	6	6	6	6	6	6	6	6	6	6	6	6	6	6	19	19	6	6	6	6	19	19	6	6	6	6	6	6	6	6	6	6	6	6	6	6	6	6	6	6	6	6	6	6	6	6	6	6	6	6	6	6	6	6	6	6	6	6	13	14	6	6	6	6	6	6	6	6	6	6	6	19	19	6	6	6	6	19	19	6	6	6	6	6	6	6	6	6	6	6	6	6	6	6	6	6	13	14	6	6	6	6	6	6	6	6	6	6	6	6	6	6	6	6	6	6	6	6	6	6	6	6	6	6	6	13	14	6	6	6	6	6	6	6	6	6	6	6	6	6	6	6	6	6	6	6	6	6	6	6	6	6	6	6	6	6	6	6	6	6	6	6	6	13	14	6	6	6	6	6	6	6	6	6	6	6	6	6	6	19	19	6	6	6	6	19	19	6	6	6	6	6	6	6	6	6	6	6	6	6	6	6	6	6	6	6	6	6	6	6	6	21	6	6	6	6	21	6	21	6	6	21	21	6	6	6	6	
6	6	6	6	6	6	6	6	6	13	14	6	6	6	6	6	6	6	6	6	6	13	14	6	6	6	6	6	6	6	6	6	6	6	6	6	6	6	6	6	6	6	6	6	6	6	6	6	6	6	6	6	6	6	6	6	6	6	6	6	6	6	6	6	6	6	6	6	6	6	6	6	6	6	6	6	6	6	6	6	6	6	6	6	6	6	6	6	6	13	14	6	6	6	6	6	6	6	6	6	6	6	6	6	6	6	6	6	6	6	6	6	6	6	6	6	6	6	6	6	6	6	6	6	6	6	6	6	6	6	6	6	6	6	6	6	6	6	6	6	6	6	6	6	6	6	6	6	6	6	6	6	6	6	6	6	6	6	6	6	6	6	6	6	6	6	6	6	6	6	6	6	6	6	6	6	6	6	6	6	6	6	6	6	6	6	6	6	6	6	6	6	6	6	6	6	6	6	6	6	6	6	6	6	6	6	6	6	6	6	6	6	6	6	6	6	6	6	6	6	6	6	6	6	6	6	6	6	6	6	6	6	6	6	21	6	6	6	6	21	6	21	6	6	6	21	6	6	6	6	
6	6	6	6	6	6	6	6	6	6	6	6	6	6	6	6	6	6	6	6	6	6	6	6	6	6	6	6	6	6	6	6	6	13	14	6	6	6	6	6	6	6	6	6	6	6	6	6	6	6	6	6	6	6	6	6	6	6	6	6	6	6	6	6	6	6	6	6	6	6	6	6	6	6	6	6	6	6	6	6	6	6	6	6	6	6	6	6	6	6	6	6	6	6	6	6	6	6	6	6	6	6	6	6	6	6	6	6	6	6	6	6	6	6	6	6	6	6	6	6	6	6	6	6	6	6	6	6	6	6	6	6	6	6	6	6	6	6	6	6	6	6	6	6	6	6	6	6	6	6	6	6	6	6	6	6	6	19	19	6	6	6	6	6	6	6	6	6	6	6	6	6	6	6	6	6	6	6	6	6	6	6	6	6	6	6	6	6	6	6	6	6	6	6	6	6	6	6	6	6	6	6	6	6	6	6	6	6	6	6	6	6	6	6	6	6	6	6	6	13	14	6	6	6	6	6	6	6	6	6	6	6	6	6	19	19	19	19	19	19	19	19	19	6	6	6	6	6	6	6	
6	6	6	6	6	6	6	6	6	6	6	6	6	6	6	6	6	6	6	6	6	6	6	6	6	6	6	6	6	6	6	6	6	6	6	6	6	6	6	6	19	19	6	6	6	6	6	6	6	6	6	6	6	13	14	6	6	6	6	6	6	6	6	6	13	14	6	6	6	6	6	6	6	6	6	6	6	6	6	6	6	6	6	6	6	6	6	6	6	6	6	6	6	6	6	6	6	19	19	6	6	6	6	6	6	6	6	6	6	6	6	6	6	6	6	6	6	6	6	6	6	6	6	6	6	6	6	6	6	6	6	13	14	19	6	6	6	6	6	6	6	6	13	14	6	6	6	6	6	6	6	6	6	6	6	6	6	6	6	6	6	6	6	6	6	6	6	6	6	13	14	6	6	6	6	6	6	6	6	6	13	14	6	6	6	6	6	6	6	6	6	6	6	6	13	14	6	6	6	6	6	6	6	6	6	19	19	6	6	6	6	6	6	13	14	6	6	6	6	6	6	6	6	6	6	6	6	6	6	6	6	6	6	6	19	13	14	19	19	19	13	14	19	6	6	6	6	6	6	6	
6	6	6	6	6	6	6	6	6	6	6	6	6	6	6	6	6	6	6	6	6	6	6	6	6	6	6	6	6	6	6	6	6	6	6	6	6	6	6	6	6	6	6	6	6	6	6	6	6	6	6	6	6	6	6	6	6	6	6	6	13	14	6	6	6	6	6	6	6	6	6	6	13	14	6	6	6	6	6	6	6	6	6	13	14	6	6	6	6	6	6	6	6	6	6	6	6	6	6	6	6	6	6	6	6	6	6	6	6	6	13	14	6	6	6	6	6	6	6	6	6	13	14	6	6	6	6	6	19	6	6	6	6	7	6	6	6	6	13	14	6	6	6	6	6	6	6	6	6	6	6	6	7	7	6	6	6	6	6	6	6	6	7	7	6	6	6	6	6	6	6	6	6	6	6	6	13	14	6	6	6	6	6	6	6	6	6	6	6	6	6	6	6	6	6	6	6	6	6	6	6	6	6	6	6	6	6	6	6	6	6	6	6	6	6	6	6	6	6	6	6	6	6	19	19	19	19	19	19	19	19	6	6	6	19	19	19	19	3	19	19	19	19	6	6	6	6	6	6	6	
6	6	13	14	6	6	19	6	6	19	6	6	19	6	6	6	6	13	14	6	6	6	6	6	6	6	13	14	6	6	6	6	6	6	6	7	7	6	6	6	6	6	6	6	6	7	7	6	6	6	6	6	6	6	6	6	6	6	6	6	6	6	6	6	6	6	6	6	6	6	6	6	6	6	6	6	6	6	6	13	14	6	6	6	6	6	6	6	6	6	6	6	7	7	6	6	6	6	6	6	6	6	7	7	6	6	6	6	6	6	6	6	6	6	6	6	6	13	14	6	6	6	6	6	6	6	6	6	7	6	6	6	6	6	6	6	6	6	6	6	6	6	6	6	6	6	7	7	7	6	6	6	6	6	7	7	6	6	6	6	7	7	6	6	6	6	6	6	6	6	6	6	6	6	6	6	6	6	6	6	6	6	6	6	6	6	6	6	6	6	6	6	6	6	6	6	6	6	19	6	7	7	6	6	6	6	6	6	6	6	7	7	6	6	6	6	6	6	6	6	6	6	6	28	28	28	28	28	28	28	28	6	6	6	19	19	19	19	19	19	19	19	19	6	6	6	6	6	6	6	
6	6	6	6	6	6	2	6	6	6	6	6	6	2	6	6	6	6	6	6	6	6	6	6	6	6	6	6	6	6	6	6	6	6	6	6	6	7	7	6	6	6	6	7	7	6	6	6	6	6	6	6	6	6	6	6	6	6	6	6	6	6	6	6	6	6	6	6	6	6	6	6	6	6	6	6	6	6	6	6	6	6	6	6	6	6	6	6	6	6	6	6	6	6	7	7	6	6	6	6	7	7	6	6	6	6	6	6	6	6	6	6	6	6	6	6	6	6	6	6	6	6	6	6	19	6	6	6	6	6	6	6	6	6	6	6	6	6	6	6	6	6	6	6	6	6	6	6	6	6	6	6	6	6	6	6	7	7	7	7	6	6	6	6	6	6	6	6	6	6	6	6	6	6	6	6	6	6	6	6	6	6	6	6	6	6	6	6	6	6	19	6	19	6	6	6	6	6	21	6	6	6	7	7	6	6	6	6	7	7	6	6	6	6	6	6	6	6	6	6	6	6	6	6	6	6	6	6	6	6	6	6	6	6	19	10	10	10	10	10	10	10	19	6	6	6	6	6	6	6	
6	6	6	6	6	24	25	6	24	1	1	1	1	25	6	6	6	6	6	6	6	6	6	6	6	6	6	6	6	6	6	6	6	6	6	6	6	6	6	7	7	7	7	6	6	6	6	6	6	6	6	6	6	6	6	6	6	6	6	6	6	6	6	6	6	6	6	6	6	6	6	6	6	6	6	6	6	6	6	6	6	6	6	6	6	6	6	6	6	6	23	6	6	6	6	6	7	7	7	7	6	6	6	6	6	6	6	6	6	6	6	6	6	19	6	19	6	6	6	6	6	6	19	6	7	6	6	6	6	6	6	6	6	6	6	6	7	6	6	6	6	6	6	6	6	6	6	6	6	6	6	6	6	13	14	6	6	6	6	6	6	6	6	6	6	6	6	6	6	6	6	6	6	6	6	6	6	6	6	6	6	6	6	6	6	6	6	6	6	6	21	6	21	6	6	19	6	6	6	6	6	6	6	6	7	7	7	7	6	6	6	6	6	6	6	7	7	7	13	14	6	6	6	6	6	6	6	6	6	6	6	6	6	6	19	19	19	19	19	19	19	19	19	6	6	6	6	6	6	6	
6	6	23	6	6	6	6	6	6	6	6	6	6	6	6	6	6	19	19	19	19	6	19	19	19	19	6	6	6	6	6	6	13	14	6	6	6	6	6	6	6	6	6	6	6	6	6	6	6	13	14	6	6	6	6	6	6	6	13	14	6	6	6	6	6	6	6	6	6	6	6	6	6	6	6	6	6	6	6	6	6	6	6	6	6	6	6	6	6	6	6	6	6	6	6	6	6	6	6	6	6	6	6	6	6	6	7	7	7	6	6	7	6	7	6	7	6	6	6	7	6	6	7	6	6	6	6	13	14	6	6	6	6	6	6	6	13	14	6	6	6	6	6	7	7	6	6	6	6	6	6	6	6	6	6	6	6	6	6	6	6	6	6	6	6	13	14	6	6	6	6	6	6	6	13	14	6	6	6	6	6	6	6	6	6	6	6	6	19	6	6	6	6	6	6	21	6	6	6	13	14	6	6	6	6	6	6	6	6	6	6	6	6	6	6	6	6	6	6	6	6	6	6	6	6	6	6	6	13	14	6	6	6	6	19	19	19	19	19	19	19	19	19	6	6	6	6	20	6	6	
6	6	6	23	6	6	6	6	6	13	14	6	6	6	7	6	6	7	7	7	7	7	7	7	7	7	10	19	10	6	6	6	6	6	6	6	6	6	6	6	6	6	13	14	6	6	6	6	6	6	6	6	6	6	6	6	6	6	6	6	6	6	6	6	6	6	6	6	13	14	6	6	6	6	6	6	6	13	14	6	6	6	6	6	6	6	6	19	6	6	6	6	6	6	6	6	6	6	6	6	6	6	6	6	6	6	13	14	6	6	6	6	6	6	6	13	14	6	6	6	6	6	6	6	6	6	6	6	6	6	6	6	6	6	6	6	6	6	6	6	7	6	6	6	6	6	13	14	6	6	6	6	6	6	6	6	6	6	6	6	6	6	6	6	6	6	6	6	6	6	6	6	6	6	6	6	6	6	6	6	6	6	6	6	13	14	6	6	21	6	6	6	13	14	6	6	6	6	6	6	6	6	6	6	6	6	6	6	6	13	14	6	6	6	6	6	6	6	6	6	6	6	6	13	14	6	6	6	6	6	6	6	6	6	24	1	1	1	1	1	1	1	1	1	1	1	1	1	1	25	
6	6	6	6	23	6	6	6	6	6	6	6	6	6	6	13	14	6	6	6	6	6	6	6	6	6	21	21	21	21	6	6	6	6	6	6	6	6	6	6	6	6	6	6	6	6	6	6	6	6	6	6	6	6	6	6	6	6	6	6	6	6	6	6	6	6	6	6	6	6	6	6	6	6	6	6	6	6	6	6	6	6	6	13	14	6	6	23	6	6	6	23	6	6	6	6	6	6	6	6	6	6	6	6	6	6	6	6	6	6	6	6	6	6	6	6	6	6	6	6	6	6	6	6	6	13	14	6	6	6	6	6	6	6	6	6	6	6	6	6	6	6	6	6	6	6	6	6	6	6	6	6	6	6	6	6	6	6	6	6	13	14	6	6	6	6	6	6	6	6	6	6	6	6	6	6	6	6	6	6	6	6	6	6	6	6	6	6	6	6	6	6	6	6	6	19	6	6	6	6	19	6	6	6	13	14	6	6	6	6	6	6	6	6	13	14	6	6	6	6	6	6	6	6	6	6	6	6	7	7	7	7	6	6	5	5	5	5	5	5	5	5	5	5	5	5	5	5	5	5	
13	14	6	6	6	23	6	6	6	6	6	6	6	6	6	6	6	6	6	6	6	6	6	6	6	6	6	6	21	21	21	21	6	6	6	6	6	6	6	6	6	6	6	6	6	6	6	6	6	6	6	6	6	6	6	6	6	6	6	6	6	6	6	6	24	1	25	6	6	6	6	6	6	6	6	6	6	6	6	6	6	6	6	6	6	6	6	6	6	6	6	6	6	6	6	13	14	6	6	6	13	14	6	6	6	6	6	6	6	6	6	6	6	6	6	6	6	6	6	13	14	6	6	6	6	6	6	6	6	6	6	6	6	6	6	6	6	6	6	6	6	6	6	6	6	6	6	6	6	6	6	6	6	6	6	6	6	6	6	6	6	6	6	6	6	6	6	6	6	6	6	6	6	6	6	6	13	14	6	6	6	6	6	6	6	19	6	6	6	19	6	6	6	6	6	21	6	6	6	6	21	6	6	6	6	6	6	6	6	6	6	6	6	6	6	6	6	6	6	7	7	7	6	6	6	7	6	6	6	6	6	6	6	6	5	5	5	5	5	5	5	5	5	5	5	5	5	5	5	5	
6	6	6	6	6	6	24	1	1	1	25	6	6	6	6	6	6	6	6	6	6	6	6	6	6	6	6	6	6	21	21	21	21	6	6	6	6	13	14	6	6	6	6	6	6	6	6	13	14	6	6	6	6	6	6	13	14	6	6	6	6	4	6	6	6	6	6	6	6	6	6	6	6	6	6	6	7	7	7	7	7	6	6	6	6	6	6	6	6	6	6	6	6	6	6	6	6	6	6	6	6	6	6	6	6	6	6	6	6	6	13	14	6	6	6	6	6	6	6	6	6	6	6	6	6	6	6	6	6	6	6	6	6	13	14	6	6	6	6	6	6	6	6	6	13	14	6	6	6	6	6	6	6	6	6	6	6	6	6	6	6	6	6	6	6	6	6	6	6	6	6	6	6	6	6	6	6	6	6	6	6	6	6	6	6	21	10	10	10	21	6	6	6	6	6	6	6	6	6	6	6	6	6	6	19	6	6	6	6	19	6	6	6	6	6	6	6	6	6	6	6	6	6	6	6	6	6	6	6	6	6	6	6	6	5	5	5	5	5	5	5	5	5	5	5	5	5	5	5	5	
6	6	6	6	6	6	6	6	6	6	6	6	6	6	6	6	6	6	6	13	14	6	6	6	6	6	6	13	14	6	6	6	6	6	6	6	6	6	6	6	6	6	6	6	6	6	6	6	6	6	6	6	6	6	6	6	6	6	6	24	1	25	6	6	6	6	6	6	6	6	6	6	6	6	6	13	14	6	6	6	6	6	6	6	23	6	6	6	23	6	6	6	6	6	6	6	6	6	6	6	6	6	6	6	6	6	6	6	6	6	6	6	6	6	6	6	6	6	6	6	6	6	6	6	6	6	6	6	13	14	6	6	6	6	6	6	6	6	6	6	6	6	6	6	6	6	6	6	6	6	6	13	14	6	6	6	6	6	6	6	6	6	6	6	6	6	6	13	14	6	6	6	6	6	6	6	6	6	6	6	6	6	6	19	6	6	6	6	6	6	6	6	6	6	13	14	6	6	6	6	6	6	6	21	21	21	6	6	6	21	6	6	7	7	7	7	6	6	6	6	6	6	13	14	6	6	6	6	6	13	14	6	6	6	5	5	5	5	5	5	5	5	5	5	5	5	5	5	5	5	
6	6	6	6	6	6	6	6	6	6	6	6	23	6	6	6	6	6	6	6	6	6	6	6	6	19	6	6	6	6	6	6	6	6	13	14	6	6	6	6	6	13	14	6	6	6	6	6	6	6	6	6	6	6	3	6	6	24	1	5	5	5	6	13	14	6	19	6	6	6	7	7	7	6	6	6	6	6	6	6	6	6	19	6	6	6	6	6	6	6	6	13	14	6	6	6	6	6	6	6	6	6	6	6	6	6	6	6	6	6	6	6	6	6	6	6	6	6	13	14	6	6	6	6	6	6	6	6	6	6	6	6	6	6	6	6	6	6	6	13	14	6	6	6	6	6	6	6	6	6	6	6	6	6	6	6	6	6	6	6	6	6	19	6	6	6	6	6	6	6	6	10	6	19	6	19	10	19	6	6	6	10	10	21	10	6	6	6	6	6	10	6	6	6	6	6	6	6	6	6	6	6	6	6	6	6	6	6	6	6	6	6	6	6	6	6	6	6	6	6	6	6	6	6	6	6	6	6	6	6	6	6	6	6	5	5	5	5	5	5	5	5	5	5	5	5	5	5	5	5	
6	6	6	13	14	6	6	6	6	6	6	23	6	6	6	6	6	6	6	6	6	6	6	6	6	28	6	6	6	6	6	6	6	6	6	6	6	6	6	6	6	6	6	6	6	6	6	6	6	6	6	6	6	6	24	1	1	5	5	5	5	5	6	6	6	6	23	6	6	6	6	6	6	6	6	6	6	6	6	6	6	6	12	6	6	6	13	14	6	6	6	6	6	6	6	6	6	6	6	6	6	6	6	6	13	14	6	6	6	6	6	6	6	6	6	6	6	6	6	6	6	6	6	6	13	14	6	6	6	6	6	6	6	6	6	6	6	6	6	6	6	6	6	6	6	6	6	13	14	6	6	6	6	6	6	13	14	6	6	6	6	24	1	25	6	6	6	6	6	6	19	24	1	1	1	1	1	1	1	1	1	1	1	1	1	1	1	1	1	1	25	8	8	8	8	8	8	8	8	8	8	8	8	8	8	8	8	8	8	8	8	8	8	8	8	8	8	8	8	8	8	8	8	8	8	8	8	8	8	8	8	8	8	8	5	5	5	5	5	5	5	5	5	5	5	5	5	5	5	5	
6	6	6	6	6	6	6	6	7	6	23	6	6	6	6	6	6	6	6	6	6	6	6	6	6	6	6	6	19	6	6	6	6	19	6	6	6	19	6	19	6	6	6	6	6	19	6	6	6	6	6	4	6	24	5	5	5	5	5	5	5	5	6	6	6	23	5	6	6	6	13	14	6	6	7	7	6	6	6	7	6	6	6	6	6	6	6	6	6	6	6	6	6	6	6	13	14	6	6	6	6	6	6	6	6	6	6	6	6	6	6	13	14	6	6	6	6	6	6	6	6	6	6	6	6	6	6	6	6	6	6	6	6	6	13	14	6	6	6	6	6	6	6	6	6	6	6	6	6	6	6	6	6	6	6	6	6	6	6	6	6	6	6	6	6	13	14	6	6	6	23	5	5	5	5	5	5	5	5	5	5	5	5	5	5	5	5	5	5	5	5	9	9	9	9	9	9	9	9	9	9	9	9	9	9	9	9	9	9	9	9	9	9	9	9	9	9	9	9	9	9	9	9	9	9	9	9	9	9	9	9	9	9	9	5	5	5	5	5	5	5	5	5	5	5	5	5	5	5	5	
6	3	6	6	6	6	24	25	6	6	6	6	6	13	14	6	6	6	6	6	28	28	28	28	6	6	6	28	28	28	28	28	6	28	6	28	6	28	6	28	28	6	28	6	28	28	6	6	3	6	6	24	1	5	5	5	5	5	5	5	5	5	23	6	23	5	5	6	6	6	6	6	6	6	6	6	6	13	14	6	6	6	6	6	6	6	6	6	6	6	6	6	6	6	6	6	6	6	19	6	19	6	6	19	19	6	6	6	19	19	6	6	6	6	6	19	6	6	6	19	6	6	6	6	6	19	6	6	6	6	6	19	6	6	6	6	19	6	6	6	19	6	6	6	19	6	19	6	6	6	19	6	6	6	6	6	6	6	19	6	6	6	13	14	6	6	6	6	19	6	6	5	5	5	5	5	5	5	5	5	5	5	5	5	5	5	5	5	5	5	5	9	9	9	9	9	9	9	9	9	9	9	9	9	9	9	9	9	9	9	9	9	9	9	9	9	9	9	9	9	9	9	9	9	9	9	9	9	9	9	9	9	9	9	5	5	5	5	5	5	5	5	5	5	5	5	5	5	5	5	
1	25	6	23	6	6	6	6	6	6	6	6	6	6	6	6	6	6	23	6	6	6	6	6	6	6	6	6	6	6	6	6	6	6	6	6	6	6	6	6	6	6	6	6	6	6	6	6	24	1	1	5	5	5	5	5	5	5	5	5	5	5	5	6	5	5	5	6	6	6	6	6	6	6	6	6	6	6	6	6	6	6	6	6	6	6	6	6	6	6	6	6	6	6	6	6	6	6	24	1	1	1	1	1	1	1	1	1	1	1	25	6	6	6	24	1	25	6	6	23	6	6	23	6	6	23	6	6	6	24	1	1	25	6	6	24	25	6	6	24	25	6	6	24	25	6	23	6	23	6	23	6	24	25	6	6	6	24	25	6	6	6	6	6	6	6	6	6	24	25	6	5	5	5	5	5	5	5	5	5	5	5	5	5	5	5	5	5	5	5	5	9	9	9	9	9	9	9	9	9	9	9	9	9	9	9	9	9	9	9	9	9	9	9	9	9	9	9	9	9	9	9	9	9	9	9	9	9	9	9	9	9	9	9	5	5	5	5	5	5	5	5	5	5	5	5	5	5	5	5	
5	5	6	5	23	6	6	6	6	3	6	6	6	6	6	6	6	23	5	8	8	8	8	8	8	8	8	8	8	8	8	8	8	8	8	8	8	8	8	8	8	8	8	8	8	8	8	8	5	5	5	5	5	5	5	5	5	5	5	5	5	5	5	6	5	5	5	6	12	12	12	6	6	19	6	6	12	12	6	12	12	12	6	6	19	19	6	6	6	19	6	19	6	19	19	24	1	1	5	5	17	17	17	17	17	17	17	17	17	17	17	17	17	17	17	17	17	17	17	17	17	17	17	17	17	17	17	17	17	17	17	17	17	17	17	17	17	17	17	17	17	17	17	17	17	17	17	17	17	17	5	6	6	6	6	6	6	6	6	6	6	6	6	6	6	10	19	6	6	6	6	5	5	5	5	5	5	5	5	5	5	5	5	5	5	5	5	5	5	5	5	9	9	9	9	9	9	9	9	9	9	9	9	9	9	9	9	9	9	9	9	9	9	9	9	9	9	9	9	9	9	9	9	9	9	9	9	9	9	9	9	9	9	9	5	5	5	5	5	5	5	5	5	5	5	5	5	5	5	5	
5	5	6	5	6	24	1	1	1	25	6	6	24	1	1	1	1	5	5	9	9	9	9	9	9	9	9	9	9	9	9	9	9	9	9	9	9	9	9	9	9	9	9	9	9	9	9	9	5	5	5	5	5	5	5	5	5	5	5	5	5	5	5	6	5	5	5	6	6	6	6	6	6	12	6	6	6	6	6	6	6	6	6	6	24	1	1	1	1	1	1	1	1	1	1	5	5	5	5	5	18	18	18	18	18	18	18	18	18	18	18	18	18	18	18	18	18	18	18	18	18	18	18	18	18	18	18	18	18	18	18	18	18	18	18	18	18	18	18	18	18	18	18	18	18	18	18	18	18	18	5	6	6	6	6	6	6	6	6	6	6	24	25	6	6	24	25	6	6	6	6	5	5	5	5	5	5	5	5	5	5	5	5	5	5	5	5	5	5	5	5	9	9	9	9	9	9	9	9	9	9	9	9	9	9	9	9	9	9	9	9	9	9	9	9	9	9	9	9	9	9	9	9	9	9	9	9	9	9	9	9	9	9	9	5	5	5	5	5	5	5	5	5	5	5	5	5	5	5	5	
5	5	10	5	8	8	8	8	8	8	8	8	5	5	5	5	5	5	5	9	9	9	9	9	9	9	9	9	9	9	9	9	9	9	9	9	9	9	9	9	9	9	9	9	9	9	9	9	5	5	5	5	5	5	5	5	5	5	5	5	5	5	5	10	5	5	5	10	10	10	10	10	10	10	10	10	10	10	10	10	10	10	24	1	5	5	5	5	5	5	5	5	5	5	5	5	5	5	5	5	18	18	18	18	18	18	18	18	18	18	18	18	18	18	18	18	18	18	18	18	18	18	18	18	18	18	18	18	18	18	18	18	18	18	18	18	18	18	18	18	18	18	18	18	18	18	18	18	18	18	5	10	10	10	10	10	10	10	10	10	10	10	10	10	10	10	10	10	10	10	10	5	5	5	5	5	5	5	5	5	5	5	5	5	5	5	5	5	5	5	5	9	9	9	9	9	9	9	9	9	9	9	9	9	9	9	9	9	9	9	9	9	9	9	9	9	9	9	9	9	9	9	9	9	9	9	9	9	9	9	9	9	9	9	5	5	5	5	5	5	5	5	5	5	5	5	5	5	5	5
