#NIVEAU
#LIGNE 15
#COLONNE 300
5	5	5	5	5	5	5	5	5	5	5	5	5	5	5	5	5	5	5	5	5	5	5	5	5	5	5	5	5	5	5	5	5	5	5	5	5	5	5	5	5	5	5	5	5	5	5	5	5	5	5	5	5	5	5	5	5	5	5	5	5	5	5	5	5	5	5	5	5	5	5	5	5	5	5	5	5	5	5	5	5	5	5	5	5	5	5	5	5	5	5	5	5	5	5	5	5	5	5	5	5	5	5	5	5	5	5	5	5	5	5	5	5	5	5	5	5	5	5	5	5	5	5	5	5	5	5	5	5	5	5	5	5	5	5	5	5	5	5	5	5	5	5	5	5	5	5	5	5	5	5	5	5	5	5	5	5	5	5	5	5	5	5	5	5	5	5	5	5	5	5	5	5	5	5	5	5	5	5	5	5	5	5	5	5	5	5	5	5	5	5	5	5	5	5	5	5	5	5	5	5	5	5	5	5	5	5	5	5	5	5	5	5	5	5	5	5	5	5	5	5	5	5	5	5	5	5	5	5	5	5	5	5	5	5	5	5	5	5	5	5	5	5	5	5	5	5	5	5	5	5	5	5	5	5	5	5	5	5	5	5	5	5	5	5	5	5	5	5	5	5	5	5	5	5	5	5	5	5	5	5	5	5	5	5	5	5	5	5	5	5	5	5	5	5	5	5	5	5	5	
5	12	13	5	5	5	5	5	5	12	13	5	5	5	5	5	5	5	5	5	5	5	5	5	5	5	5	5	5	5	5	5	5	5	5	5	5	5	5	5	12	13	5	5	5	5	5	5	12	13	5	5	5	5	5	5	5	5	5	5	5	5	5	5	5	5	5	5	5	5	5	18	18	18	18	5	18	18	18	18	5	5	18	5	5	5	5	5	5	5	5	5	5	5	5	5	12	13	5	5	5	5	5	5	12	13	5	5	5	5	5	5	5	5	12	13	5	5	5	5	5	5	12	13	5	5	5	5	5	5	5	5	5	5	5	5	5	5	5	5	5	5	5	5	5	5	5	5	5	5	12	13	5	5	5	5	5	5	12	13	5	5	5	5	5	5	5	5	5	5	5	5	5	5	5	5	5	5	5	5	5	5	5	5	5	5	5	5	5	5	5	5	5	5	5	5	5	5	5	5	5	5	5	5	5	5	5	5	5	5	5	5	5	5	5	5	5	5	5	5	5	5	5	5	5	5	5	5	5	5	5	5	5	5	5	5	5	5	5	5	5	5	5	5	5	5	5	12	13	5	5	5	5	5	5	12	13	5	5	5	5	5	5	5	5	5	5	5	5	5	5	5	5	5	5	5	5	5	5	5	5	5	5	5	5	5	5	5	5	5	5	5	5	5	5	5	5	5	5	5	
5	5	5	5	5	12	13	5	5	5	5	5	5	5	5	5	5	5	5	12	13	5	5	5	5	5	5	5	5	5	5	5	5	5	5	5	5	5	5	5	5	5	5	5	12	13	5	5	5	5	5	5	5	5	5	5	5	5	5	5	5	5	5	5	5	5	5	5	5	5	5	18	5	5	5	5	18	5	5	5	5	5	18	5	5	5	5	5	5	5	5	5	5	5	5	5	5	5	5	5	12	13	5	5	5	5	5	5	5	5	5	5	5	5	5	5	5	5	12	13	5	5	5	5	5	5	5	5	5	5	5	5	12	13	5	5	5	5	5	5	12	13	5	5	5	5	5	5	5	5	5	5	5	5	12	13	5	5	5	5	5	5	5	5	5	5	5	5	5	5	5	5	5	5	5	5	5	5	5	5	5	5	5	5	5	5	12	13	5	5	5	5	5	5	12	13	5	5	5	5	5	5	5	5	5	5	5	5	5	5	5	5	5	5	5	5	5	5	5	5	12	13	5	5	5	5	5	5	12	13	5	5	5	5	5	5	5	5	5	5	5	5	5	5	5	5	5	5	5	5	5	12	13	5	5	5	5	5	5	5	5	5	5	5	5	5	5	5	5	5	5	5	5	5	5	5	5	5	5	5	5	5	5	5	5	5	5	5	5	5	5	5	5	5	5	5	5	5	5	5	
5	5	5	5	5	5	5	5	5	5	5	5	5	5	5	5	5	5	5	5	5	5	5	12	13	5	5	12	13	5	5	5	5	5	5	12	13	5	5	5	5	5	5	5	5	5	5	5	5	5	5	5	5	5	5	5	5	5	5	5	5	5	5	5	5	5	5	5	5	5	5	18	18	18	5	5	18	18	18	18	5	5	18	5	5	5	5	5	5	5	5	5	5	5	5	5	5	5	5	5	5	5	5	5	5	5	5	5	5	5	5	5	5	5	5	5	5	5	5	5	5	5	5	5	5	5	5	5	5	5	5	5	5	5	5	5	12	13	5	5	5	5	5	5	5	5	5	5	5	5	5	5	5	5	5	5	5	5	5	5	5	5	5	5	5	5	5	5	5	5	5	5	5	5	5	5	5	5	5	5	5	5	5	5	5	5	5	5	5	5	12	13	5	5	5	5	5	5	5	5	5	5	5	5	5	5	5	5	5	5	5	5	5	5	5	5	5	5	5	5	5	5	5	5	12	13	5	5	5	5	5	5	5	5	5	5	5	5	5	5	5	5	5	5	5	5	5	5	5	5	5	5	5	5	5	5	5	5	5	5	5	5	5	5	5	5	5	5	5	5	5	5	5	5	5	5	5	5	5	5	5	5	5	5	5	5	5	5	5	5	5	5	5	5	5	5	5	5	5	5	
5	5	5	5	5	5	5	5	5	5	5	5	5	5	5	5	5	5	5	5	5	5	5	5	5	5	5	5	5	5	5	5	5	5	5	5	5	5	5	5	5	5	5	5	5	5	5	5	5	5	5	5	5	5	12	13	5	5	5	5	5	5	12	13	5	5	5	5	5	5	5	18	5	5	5	5	5	5	5	18	5	5	18	5	5	5	5	5	5	5	5	5	5	5	5	5	5	5	5	5	5	5	5	5	5	5	5	5	5	5	12	13	5	5	5	5	5	5	5	5	5	5	5	5	5	5	5	5	12	13	5	5	5	5	5	5	5	5	5	5	5	5	5	5	5	5	5	5	5	5	5	5	5	5	5	5	5	5	5	5	5	5	5	5	12	13	5	5	12	13	5	5	5	5	5	5	12	13	5	5	5	5	5	5	5	5	5	5	5	5	5	5	5	5	5	5	5	5	5	5	5	5	5	5	5	5	5	5	5	5	5	5	5	5	5	5	5	5	5	5	5	5	5	5	5	5	5	5	5	5	5	5	5	5	5	5	5	5	5	5	5	5	5	5	5	5	5	5	5	5	5	5	5	5	5	5	5	5	5	5	5	5	5	12	13	5	5	5	5	5	5	12	13	5	5	5	5	5	5	12	13	5	5	5	5	5	5	12	13	5	5	5	5	5	5	5	5	5	5	5	
5	5	5	5	5	5	5	5	5	5	5	5	5	5	5	12	13	5	5	5	5	5	5	5	5	5	5	12	13	5	5	5	5	5	5	12	13	5	5	5	5	5	5	5	5	5	5	5	5	5	5	5	5	5	5	5	5	5	12	13	5	5	5	5	5	5	5	5	5	5	5	18	18	18	18	5	18	18	18	18	5	5	18	5	5	5	5	5	5	5	5	5	5	5	5	5	5	5	5	5	5	5	5	5	5	5	5	5	5	5	5	5	5	5	5	5	5	5	5	5	5	5	5	5	5	5	5	5	5	5	5	5	5	5	5	5	5	5	5	5	5	5	5	5	5	5	12	13	5	5	5	5	5	5	5	5	5	5	5	5	5	5	5	5	5	5	5	5	5	5	5	5	12	13	5	5	5	5	5	5	5	5	5	5	5	5	5	5	5	5	5	5	5	5	5	5	5	5	5	5	5	5	5	5	5	5	5	5	5	5	5	5	5	5	5	5	5	5	5	5	5	5	5	5	5	5	5	5	5	5	5	5	5	5	12	13	5	5	12	13	5	5	5	5	5	5	5	5	5	5	5	5	5	5	5	5	5	5	5	5	5	5	5	5	5	5	5	12	13	5	5	5	5	5	5	5	5	5	5	5	5	5	5	12	13	5	5	5	5	5	5	5	5	5	5	5	5	5	5	5	
13	5	5	5	5	5	5	12	13	5	5	5	5	5	5	5	5	5	5	5	5	5	5	5	5	5	5	5	5	5	5	12	13	5	5	5	5	5	5	5	5	5	5	12	13	5	5	5	5	5	5	5	5	5	5	5	5	5	5	5	5	5	5	5	5	5	5	5	5	5	5	5	5	5	5	5	5	5	5	5	5	5	5	5	5	5	5	5	5	5	5	5	5	5	5	5	5	5	5	12	13	5	5	5	5	5	5	5	5	5	5	5	5	5	5	5	5	12	13	5	5	5	5	5	5	5	5	5	5	5	5	5	5	5	5	5	5	5	5	5	5	5	5	5	5	5	5	5	5	5	5	5	5	12	13	5	5	5	5	5	5	5	5	5	5	5	5	5	5	5	5	5	5	5	5	5	5	5	5	5	5	5	5	5	5	5	5	5	5	5	5	5	5	5	5	5	5	5	5	5	5	5	12	13	5	5	5	5	5	5	12	13	5	5	5	5	5	5	5	5	5	5	5	5	5	5	5	5	5	5	5	5	5	5	5	5	5	5	5	5	5	5	12	13	5	5	5	5	5	5	12	13	5	5	5	5	5	5	5	5	5	5	5	5	5	5	5	5	5	5	5	5	5	5	5	5	5	5	5	5	5	5	5	5	5	5	5	5	5	5	5	5	5	5	5	5	5	5	5	5	
5	5	5	12	13	5	5	5	5	5	5	5	5	5	5	5	5	5	5	5	5	5	5	5	5	5	5	5	5	5	5	5	5	5	5	5	5	5	5	5	5	5	5	5	5	5	5	12	13	5	5	5	5	5	5	5	5	5	5	5	5	5	5	5	5	5	5	5	5	18	5	5	5	5	5	5	5	5	5	5	5	0	0	0	5	5	5	18	18	18	18	18	18	5	5	5	5	5	5	5	5	5	5	12	13	5	5	5	5	5	5	5	5	5	5	5	5	5	5	5	5	12	13	5	5	5	5	5	5	5	5	5	5	5	5	12	13	5	5	5	5	5	5	5	5	5	5	5	5	5	5	5	5	5	5	5	5	12	13	5	5	5	5	5	5	5	5	5	5	5	5	5	5	5	5	5	5	5	5	5	5	5	12	13	5	5	5	5	5	12	13	5	5	5	5	5	5	5	5	5	5	5	5	5	5	5	12	13	5	5	5	5	5	5	5	5	5	5	5	5	5	5	5	12	13	5	5	5	5	5	5	5	5	5	5	5	5	5	5	5	5	5	5	5	5	5	5	5	5	5	5	5	5	5	12	13	5	5	5	5	5	5	5	5	5	5	5	5	5	5	5	5	5	5	5	5	5	5	5	5	5	5	5	5	5	5	5	5	5	5	5	5	5	12	13	5	5	5	5	5	
5	5	5	5	5	5	5	5	5	5	5	5	5	5	12	13	18	5	5	5	5	5	5	5	5	5	5	5	5	5	5	5	5	5	5	5	5	5	5	12	13	5	5	5	5	5	5	5	5	5	5	5	5	5	5	5	5	5	5	12	13	5	5	5	5	5	5	12	13	5	18	18	5	5	10	5	5	0	0	0	18	4	4	4	5	5	5	18	11	18	18	18	18	5	5	12	13	5	5	5	5	5	5	5	5	5	5	5	5	5	5	5	5	12	13	5	5	5	5	5	5	5	5	5	5	5	5	5	5	5	5	5	5	5	5	5	5	5	5	12	13	5	5	5	5	5	5	5	5	12	13	5	5	5	5	5	5	5	5	5	5	5	5	5	5	5	5	5	5	5	5	5	5	5	5	5	5	5	5	5	5	5	5	5	5	5	5	5	5	5	5	5	5	12	13	5	5	5	5	5	5	5	5	5	5	5	5	5	5	5	5	5	5	5	5	5	5	5	5	5	5	5	5	5	5	5	5	12	13	5	5	5	5	5	5	5	5	5	5	5	5	5	5	5	5	5	12	13	5	5	5	5	5	5	5	5	5	5	5	5	5	5	5	5	5	5	5	5	5	5	5	5	5	5	5	5	5	5	5	5	5	5	5	5	5	5	5	5	5	5	5	5	5	5	5	5	5	5	5	5	
5	5	5	5	5	5	5	5	5	5	5	5	5	5	5	18	5	18	5	5	5	12	13	5	5	5	5	5	5	5	5	5	5	18	18	5	5	5	5	5	5	5	18	5	5	5	5	5	5	5	5	5	5	5	5	5	5	5	5	5	5	5	5	12	13	5	5	5	5	5	10	5	5	0	0	0	5	4	4	4	18	4	4	4	5	5	5	18	11	11	18	18	18	5	5	5	5	5	5	5	5	5	5	5	5	5	5	5	5	5	5	5	18	18	5	5	5	5	5	5	5	5	5	5	5	5	5	5	5	5	5	12	13	5	5	5	5	5	5	5	5	5	5	5	5	5	5	5	5	5	5	5	5	5	5	5	5	5	5	5	5	5	5	5	5	5	5	5	5	5	5	12	13	5	5	5	5	5	5	5	5	5	5	5	5	12	13	5	5	5	5	5	5	5	5	5	5	5	5	5	5	5	5	5	5	5	5	5	5	5	5	5	5	5	5	5	12	13	5	12	13	5	5	5	5	5	5	5	5	5	5	5	5	5	5	5	5	5	5	5	5	5	5	5	5	5	5	5	5	5	5	5	5	5	5	5	5	5	5	5	5	5	5	5	5	5	12	13	5	5	5	5	5	5	5	5	5	5	5	5	5	5	12	13	5	5	5	5	5	5	5	5	5	5	5	5	5	5	5	5	
5	5	5	5	5	5	5	5	5	5	5	5	18	10	18	5	5	5	18	5	5	5	5	5	5	5	5	5	5	5	5	5	18	18	18	18	5	5	5	5	5	5	18	18	18	5	5	5	5	5	12	13	5	5	5	5	5	18	18	5	5	5	5	5	18	5	10	5	18	0	0	0	5	4	4	4	18	4	4	4	18	4	4	4	5	5	5	11	11	11	18	18	18	5	5	5	5	5	5	5	5	5	18	18	18	5	5	5	5	5	5	5	18	18	5	5	18	5	5	5	5	5	5	5	5	5	5	5	5	5	5	5	5	5	5	5	5	5	5	5	5	5	5	5	5	5	5	5	5	5	5	5	5	5	5	5	5	5	5	5	5	5	5	5	5	5	5	5	5	5	5	5	5	5	5	12	13	5	5	5	5	5	5	5	5	5	5	5	5	5	5	5	5	5	5	5	5	5	5	5	5	5	5	5	5	5	5	5	5	5	5	5	5	5	5	5	5	5	5	5	5	5	5	5	5	5	5	5	5	5	5	5	5	5	5	5	5	5	5	5	5	12	13	5	5	5	5	5	5	5	5	5	5	5	5	5	5	5	5	5	5	5	5	5	5	5	5	5	5	5	12	13	5	5	5	5	5	5	5	5	5	5	5	5	5	5	12	13	5	5	5	5	5	5	5	5	5	5	5	5	
5	5	5	18	18	18	18	5	5	5	5	10	11	11	11	5	5	5	11	5	11	11	5	18	18	18	18	5	5	2	1	18	18	18	18	18	18	2	2	15	5	5	18	18	18	18	5	5	5	18	18	5	5	18	18	18	5	18	18	18	5	2	9	2	5	0	0	0	18	4	4	4	5	4	4	4	18	4	4	4	18	4	4	4	5	5	5	11	11	11	11	18	18	5	5	18	18	18	18	18	18	18	18	18	18	18	18	18	18	18	18	5	6	6	5	5	6	5	5	5	5	5	5	5	5	5	5	5	5	5	5	5	4	0	5	5	5	0	5	5	5	5	5	5	5	5	5	5	5	5	5	5	5	5	5	5	5	5	5	5	5	5	5	5	5	5	5	12	13	5	5	5	5	5	5	5	5	5	5	5	5	5	5	5	5	5	5	5	5	5	5	5	5	5	5	5	5	5	5	5	5	5	5	5	5	12	13	5	5	5	5	5	5	5	5	5	5	5	5	5	5	5	5	5	5	5	5	5	5	5	5	5	5	5	5	5	5	5	5	5	5	5	5	5	5	12	13	5	5	5	5	5	5	5	5	5	5	5	5	5	5	5	12	13	5	5	5	5	5	5	5	5	5	5	5	5	5	5	12	13	5	5	5	5	5	5	5	5	5	5	5	5	5	5	5	5	5	5	5	5	
5	5	5	18	5	5	18	5	5	18	11	11	5	5	5	5	5	11	5	5	5	5	5	11	5	18	18	1	0	0	0	6	6	6	6	6	6	0	0	0	5	5	2	2	1	1	2	5	5	3	1	5	5	18	1	3	5	19	10	19	5	0	0	0	5	4	4	4	18	4	4	4	5	4	4	4	18	4	4	4	18	4	4	4	5	5	5	11	11	11	11	11	10	5	5	5	5	5	5	5	5	5	5	5	5	5	5	18	18	18	18	5	5	5	5	5	5	5	5	5	5	5	5	5	5	5	5	5	5	5	5	5	5	5	5	0	0	4	5	5	5	5	5	5	5	5	5	5	5	5	5	5	5	5	5	5	5	5	5	5	5	5	5	5	5	5	5	5	5	5	5	5	5	5	5	5	5	5	5	5	5	5	5	5	5	5	5	5	5	5	5	5	5	5	5	5	5	5	5	5	5	5	5	5	5	5	5	5	5	12	13	5	5	5	5	5	5	5	5	5	5	5	5	5	5	5	5	5	5	5	5	5	5	5	5	5	5	12	13	5	5	5	5	5	5	5	5	5	5	5	5	5	5	5	5	5	5	5	5	5	5	5	5	12	13	5	5	5	5	5	5	5	5	5	5	5	5	5	5	5	5	5	5	5	5	5	5	5	5	5	5	5	5	5	5	5	5	5	5	5	
5	3	5	2	2	2	5	1	5	9	3	3	2	2	5	5	5	5	5	5	5	5	10	11	11	1	1	0	4	4	4	18	18	18	18	18	18	4	4	4	5	5	0	0	0	0	0	5	5	0	0	5	5	0	0	0	5	0	0	0	5	4	4	4	5	4	4	4	5	4	4	4	5	4	4	4	18	4	4	4	18	4	4	4	5	5	5	0	0	0	0	0	0	6	6	6	6	6	6	6	6	6	6	6	6	6	6	6	5	5	6	6	5	6	6	6	5	6	6	6	6	6	6	6	3	1	2	1	1	1	3	3	2	2	1	4	4	4	5	5	5	5	5	5	5	5	5	5	5	5	5	5	5	5	5	5	5	5	5	5	5	5	5	5	5	5	5	5	5	5	5	5	5	5	5	5	5	5	5	5	5	5	5	5	5	5	5	5	5	5	5	5	5	5	5	5	5	5	5	5	5	12	13	5	5	5	5	5	5	5	5	5	5	5	5	5	5	5	5	5	5	5	5	5	5	5	5	5	5	5	5	5	5	5	5	5	5	5	5	5	5	5	5	5	5	5	5	5	5	5	5	5	5	5	5	5	5	5	5	5	5	5	5	5	5	5	5	5	5	5	5	5	5	5	5	5	5	5	5	5	5	5	5	5	5	5	5	5	5	5	5	5	5	5	5	5	5	5	5	5	
0	0	0	0	0	0	0	0	0	0	0	0	0	0	7	7	7	7	7	7	7	7	0	0	0	0	0	4	4	4	4	7	7	7	7	7	7	4	4	4	7	7	4	4	4	4	4	7	7	4	4	7	7	4	4	4	7	4	4	4	7	4	4	4	7	4	4	4	7	4	4	4	7	4	4	4	7	4	4	4	7	4	4	4	7	7	7	4	4	4	4	4	4	7	7	7	7	7	7	7	7	7	7	7	7	7	7	7	7	7	7	7	7	7	7	7	7	7	7	7	7	7	7	7	0	0	0	0	0	0	0	0	0	0	0	4	4	4	5	5	5	5	5	5	5	5	5	5	5	5	5	5	5	5	5	5	5	5	5	5	5	5	5	5	5	5	5	5	5	5	5	5	5	5	5	5	5	5	5	5	5	5	5	5	5	5	5	5	5	5	5	5	5	5	5	5	5	5	5	5	5	5	5	5	5	5	5	5	5	5	5	5	5	5	5	5	5	5	5	5	5	5	5	5	5	5	5	5	5	5	5	5	5	5	5	5	5	5	5	5	5	5	5	5	5	5	5	5	5	5	5	5	5	5	5	5	5	5	5	5	5	5	5	5	5	5	5	5	5	5	5	5	5	5	5	5	5	5	5	5	5	5	5	5	5	5	5	5	5	5	5	5	5	5	5	5	5	5	5	5

